R 3840 2160
NO ./srcs/textures/stone.xpm
SO ./srcs/textures/wood.xpm
WE ./srcs/textures/mossy.xpm
EA ./srcs/textures/redbrick.xpm

S ./srcs/textures/pillar.xpm
F 57, 0, 188 
C 50, 151, 51 

		1111111111111111111111111
		1000000000110000000000001
		1011000001110002000000001
		1001000000000000000N00001
111111111011000001110000000000001
100000000011000001110111111111111
11110111111111011100000010001
11110111111111011101010010001
11000000110101011100000010001
10020000000000001100000010001
10000000000000001101010010001
11000001110101011111011110001
11110111 1110101 101111010001
11111111 1111111 111111111111